{
    "damaged_tiles_appearing_probability": 1,
    "complete_time": 30,
    "tram_speed": 4,
    "text": "Yooo this is test 1",
    "tram_untouchable_radius": 5,
    "tiles": [
        "====================",
        "======(===========)=",
        "======|===========|=",
        "======[==w======q=]=",
        "=========|======|===",
        "=====(==hx=h=)==|===",
        "=====|===|===v==|===",
        "=====|===[===+==]===",
        "=====[===)===|======",
        "=========[=h=]======",
        "====================",
        "====================",
        "====================",
        "====================",
        "===================="
    ],
    "trams": [
        [8, 1, "r"],
        [6, 5, "l"]
    ]
}