{
    "damaged_tiles_appering_precent": 10,
    "map": [
        "00000000000000000000",
        "000000(===========)0",
        "000000|00000000000|0",
        "000000[==w=====q==]0",
        "000000000|00000|0000",
        "00000(==hx=h=)0|0000",
        "00000|000|000v0|0000",
        "00000|000[===+=]0000",
        "00000[===)000|000000",
        "000000000[=h=]000000",
        "00000000000000000000",
        "00000000000000000000",
        "00000000000000000000",
        "00000000000000000000",
        "00000000000000000000"
    ],
    "trams_positions": [
        [0, 0, "u"],
        [1, 0, "d"],
        [2, 0, "l"],
        [3, 0, "r"]
    ]
}